111111111111111111
1PEC10000001001001
111110000001111111
111001000000000001
101111000000101111
100000000000100001
111111111111111111
